11111111111111
1P0C0E11111111
10000011111111
1X0Y0011111111
11111111111111
