11111111111111111
1P000011111111111
11111111111111111
10000E11111111111
11111111111111111
