11111111111111111
1P010011111111111
100X0011111111111
100C0E11111111111
11111111111111111
