11111111111111111
1P1YE011111111111
10000011111111111
1C000011111111111
11111111111111111
