1111111
1P0C0E1
1000001
1X0Y001
1111111