111111111111111
100E11111111111
10C011111111111
111111111111111
