1111111111111111111111111
1P000000000000Y00000000E1
111C1111111C1111111111111
1111111111111111111111111
