111111111111111
1P0P11111111111
10C011111111111
111111111111111
