111111111111111
1P0C11111111111
100011111111111
111111111111111
