111111111111111
1P0011111111111
100E11111111111
111111111111111
