1111111111111111
1P0C011111111111
1000011111111111
1101111111111111
