11111111111111111
1P000011111111111
11110111111111111
1C100E11111111111
11111111111111111
