111111111111
1P0000000001
100001011001
100001011001
100001000001
10C0010000E1
111111111111