1111111111111
1P0C000000001
1000010110001
1000010110001
1000010000001
1000010000E01
1111111111111