11111111
10000001
100P0001
10001001
10C00Y01
1000X0E1
11111111