111111111111111
100000000000001
100P00000000001
100010000000001
10C00Y000000001
1000X0E00000001
111111111111111