111111111111111111111
1P00100X10000000000E1
10001010101111100X001
100010101010XC1000001
11101C101010000Y00001
1C1011100C1C0010000Y1
10000Y101111011000001
111011101111011011111
1C0000000000000X000C1
111111111111111111111
