11111111
1P000001
10000001
10001001
10C00001
1000X0E1
11111111