1111111111111
1P00000000001
1000000000001
1000000000001
1000000000001
1000000000001
1E000000000C1
1111111111111