1111111111111
1P000000X0001
1000000000001
1000000000001
1000000000001
1000000000001
1E000000000C1
1111111111111