111111111111111111
1P0000000XC00000E1
111111110011111111
111111110C11111111
111111111111111111