1111111111111111111
100000000P000000001
1000000000000E000C1
1000000000000000001
1111111111111111110