1111111111111111111
1P0000000Y0C00000E1
1111101111111111111
1111111111111111111