111111111111111111
10000000P00010E011
100000000000100111
100000000000101111
100000000000X0C111
100000000000X00111
111111111111111111