1111111111111111111111
1P00100X00000000000E1
100010101000000000001
100010101000000000001
11101C101110000000001
101011100C10000000001
10000Y101111110000001
111011101000011011111
1C0000000000000X000C1
111111111111111111111