111111111111111111111111
1P00000000000000000X0001
100000000Y00001111000001
1C00000000000000000000E1
111111111111111111111111