111111111111
1P000C000001
100001011001
10N001011001
10000100C001
10C0010000E1
111111111111